##########################
#.......................S#
#.########################
#........................#
#..#..#..#..#..#..#..#..##
##.##....#..#..#.######..#
#...#....#..#..#..####...#
#.######.##.##.##.###..###
#......#.#..#..#..########
######...########........#
#########.........######.#
##############.#########.#
###########..............#
##..........#########.####
###########..............#
########################.#
#E.......................#
##########################