##########################
#.......................A#
#.########################
#..........F.............#
#..#..#..#..#..#..#..#..##
##B##....#..#..#.######..#
#...#....#..#..#..####..C#
#.######.##.##.##.###..###
#......#.#..#..#..########
######...########........#
#########.........######.#
##############D#########.#
###########..............#
##G.........#########.####
###########..............#
########################.#
#E.......................#
##########################